

								



NO 		 ./img/wall/North.xpm
SO                                                                          ./img/wall/South.xpm
WE																			./img/wall/West.xpm
EA	 	 	 	 ./img/wall/East.xpm


F 255 	, 	255 ,             125
C		 0	,	 100       ,								255

11111111111111111111111111111111111111111111111111111111111111111111111111111111111111111111111111111111111
1N111111111111111111111111111111111111111111111111111111111111111111111111111111111111111111111111111111111
1010000000001111111111111111111111111111111111111111111111111111111110dX00000000000000000000000011111111111
10101111101000011111111111111111111111111111111111111111111111111111101000000000000000000000000011111111111
1010111110111101111111111111110000X0000C111111111111111111111111111110100000000C0000000C0000000011111111111
100011111D1111011111111111111100000000001111111111111111111111111111101000000000000000000000000011111111111
11111C00001110011110000000000d0X0000C000111111111111111111111111111110100000000000C000000000000011111111111
1111110111000001111011111111110000X0000C1111111111111111111111111111101000000000000000000000000011111111111
111111X1100110011110111111111111111111111111111111111111111111111111101000000000000000000000000011111111111
1111111110111000110011111111111111111111111111111111111111111111111110100000000C0000000C0000000011111111111
11111111101111000000111111111111111111111111111000000000000000000000001000000000000000000000000011111111111
1111111110111111111000C111111111111111111111111011111111111111111111111111111111111111111111111111111111111
11111000d000000X111010010C111111111111111111111011111111111111111111111111111111111111111111111111111111111
11110001111011111110100100111111111111111111111011111111111111111111111111111111111111111111111111111111111
111000011110111111101X0100111111111111111111111011111111111111111111111111111111111111111111111111111111111
11100001111011111110100100111111111111111111111011111111111111111111111111111111111111111111111111111111111
1110CC01111011111110100100111111111111111111111011111111111111111111111111111111111111111111111111111111111
11111111111011111110100100000111111111111111111011111111111111111111111111111111111111111111111111111111111
11111111111011111110100100000111111111111111111011111111111111111111111111111111111111111111111111111111111
111111111110111111101C1100000111111111111111111011111111111111111111111111111111111111111111111111111111111
111111111110111111100d000000000000000000d000000000000111111111111111111111111111111111111111111111111111111
11111111111X1111111000111111110X000000X01111111111111111111111111111111111111111111111111111111111111111111
11111111111D111111100d0000C1110000XX00001111111111111111111111111111111111111111111111111111111111111111111
11111111111C111111111111X001110C000000C01111111111111111111111111111111111111111111111111111111111111111111
11111111111111111111111111111111111111111111111111111111111111111111111111111111111111111111111111111111111