

								



NO 		 ./img/wall/North.xpm
SO                                                                          ./img/wall/South.xpm
WE																			./img/wall/West.xpm
EA	 	 	 	 ./img/wall/East.xpm


F 255 	, 	255 ,             125
C		 0	,	 100       ,								255



111
1N1
101
101
101
101
101
101
101
101
101
101
101
101
101
101
101
101
101
101
101
101
101
101
101                           1111111111
101                           1X000C1111
101                           1011111111
101                           1011111111
101                           1011111111
101                           1011111111
101                           1011111111
101                           1011111111
101                           1011111111
101                           1011111111
101                           1011111111
101                           1011111111
101                           1011111111
101                           1011111111
101                           1011111111
101                           1011111111
101                           1011111111
101                           1011111111
101                           1011111111
101                           1011111111
101                           1011111111
101                           1011111111
101                           1011111111
101                           1011111111
101                           1011111111
101                           1011111111
101                           1011111111
101                           1011111111
101                           1011111111
101                           1011111111
101                           1011111111
101                           1011111111
101                           1011111111
101                           1011111111
101                           1011111111
101                           1011111111
101                           1011111111
101                           1011111111
101                           1011111111
101                           1011111111
101                           1011111111
101                           1011111111
101                           1011111111
101                           1011111111
101                           1011111111
101                           1011111111
101                           1011111111
101                           1011111111
101                           1011111111
101                           1011111111
101                           1011111111
101                           1011111111
101                           1011111111
101                           1011111111
101                           1011111111
101                           1011111111
101                           1011111111
101                           1011111111
101                           1011111111
101                           1011111111
101                           1011111111
101                           1011111111
101                           1011111111
101                           1011111111
101                           1011111111
101                           1011111111
101                           1011111111
101                           1011111111
101                           1011111111
101                           1011111111
101                           1011111111
101                           1011111111
101                           1011111111
101                           1011111111
101                           1011111111
101                           1011111111
101                           1011111111
101                           1011111111
101                           1011111111
101                           1011111111
101                           1011111111
101                           1011111111
101                           1011111111
101                           1011111111
101                           1011111111
101                           1011111111
101                           1011111111
101                           1011111111
101                           1011111111
101                           1011111111
101                           1011111111
101                           1011111111
101                           1011111111
101                           1011111111
101                           1011111111
101                           1011111111
101                           1011111111
101                           1011111111
101                           1011111111
101                           1011111111
101                           1011111111
101                           1011111111
101                           1011111111
101                           1011111111
101                           1011111111
101                           1011111111
101                           1011111111
101                           1011111111
101                           1011111111
101                           1011111111
101                           1011111111
101                           1011111111
101                           1011111111
101                           1011111111
101                           1011111111
101                           1011111111
101                           1011111111
101                           1011111111
101                           1011111111
101                           1011111111
101                           1011111111
101                           1011111111
101                           1011111111
101                           1011111111
101                           1011111111
101                           1011111111
101                           1011111111
101                           1011111111
101                           1011111111
101                           1011111111
101                           1011111111
101                           1011111111
101                           1011111111
101                           1011111111
101                           1011111111
101                           1011111111
101                           1011111111
101                           1011111111
101                           1011111111
101                           1011111111
101                           1011111111
101                           1011111111
101                           1011111111
101                           1011111111
101                           1011111111
101                           1011111111
101                           1011111111
101                           1011111111
101                           1011111111
101                           1011111111
101                           1011111111
101                           1011111111
101                           1011111111
101                           1011111111
101                           1011111111
101                           1011111111
101                           1011111111
101                           1011111111
101                           1011111111
101                           1011111111
101                           1011111111
101                           1011111111
101                           1011111111
101                           1011111111
101                           1011111111
101                           1011111111
101                           1011111111
101                           1011111111
101                           1011111111
101                           1011111111
101                           1011111111
101                           1011111111
101                           1011111111
101                           1011111111
101                           1011111111
101                           1011111111
101                           1011111111
101                           1011111111
101                           1011111111
101                           1011111111
101                           1011111111
101                           1011111111
101                           1011111111
101                           1011111111
101                           1011111111
101                           1011111111
101                           1011111111
101                           1011111111
101                           1011111111
101                           1011111111
101                           1011111111
101                           1011111111
101                           1011111111
101                           1011111111
101                           1011111111
101                           1011111111
101                           1011111111
101                           1011111111
101                           1011111111
101                           1011111111
101                           1011111111
101                           1011111111
101                           1011111111
101                           1011111111
101                           1011111111
101                           1011111111
101                           1011111111
101                           1011111111
101                           1011111111
101                           1011111111
101                           1011111111
101                           1011111111
101                           1011111111
101                           1011111111
101                           1011111111
101                           1011111111
101                           1011111111
101                           1011111111
101                           1011111111
101                           1011111111
101                           1011111111
101                           1011111111
101                           1011111111
101                           1011111111
101                           1011111111
101                           1011111111
101                           1011111111
101                           1011111111
101                           1011111111
101                           1011111111
101                           1011111111
101                           1011111111
101                           1011111111
101                           1011111111
101                           1011111111
101                           1011111111
101                           1011111111
101                           1011111111
101                           1011111111
101                           1011111111
101                           1011111111
101                           1011111111
101                           1011111111
101                           1011111111
101                           1011111111
101                           1011111111
101                           1011111111
101                           1011111111
101                           1011111111
101                           1011111111
101                           1011111111
101                           1011111111
101                           1011111111
101                           1011111111
101                           1011111111
101                           1011111111
101                           1011111111
101                           1011111111
101                           1011111111
101                           1011111111
101                           1011111111
101                           1011111111
101                           1011111111
101                           1011111111
101                           1011111111
101                           1011111111
101                           1011111111
101                           1011111111
101                           1011111111
101                           1011111111
101                           1011111111
101                           1011111111
101                           1011111111
101                           1011111111
101                           1011111111
101                           1011111111
101                           1011111111
101                           1011111111
101                           1011111111
101                           1011111111
101                           1011111111
101                           1011111111
101                           1011111111
101                           1011111111
101                           1011111111
101                           1011111111
101                           1011111111
101                           1011111111
101                           1011111111
101                           1011111111
101                           1011111111
101                           1011111111
101                           1011111111
101                           1011111111
101                           1011111111
101                           1011111111
101                           1011111111
101                           1011111111
101                           1011111111
101                           1011111111
101                           1011111111
101                           1011111111
101                           1011111111
101                           1011111111
101                           1011111111
101                           1011111111
101                           1011111111
101                           1011111111
101                           1011111111
101                           1011111111
101                           1011111111
101                           1011111111
101                           1011111111
101                           1011111111
101                           1011111111
101                           1011111111
101                           1011111111
101                           1011111111
101                           1011111111
101                           1011111111
101                           1011111111
101                           1011111111
101                           1011111111
101                           1011111111
101                           1011111111
101                           1011111111
101                           1011111111
101                           1011111111
101                           1011111111
101                           1011111111
101                           1011111111
101                           1011111111
101                           1011111111
101                           1011111111
101                           1011111111
101                           1011111111
101                           1011111111
101                           1011111111
101                           1011111111
101                           1011111111
101                           1011111111
101                           1011111111
101                           1011111111
101                           1011111111
101                           1011111111
101                           1011111111
101                           1011111111
1011111111111111111111111111111D11111111
1000000000000000000000000000000000000001
1100000000000000000100000X00000000000001
1100000000000000000100X00C00X00000000001
1100000000000000000100000000000000000001
1100000000000000000000000000000000000001
1111111111111111100000000000000011111111
110000000X000000000000001100000000001111
1100000000000000000000001100000000001111
1111100000000000000000001100000000001111
110X000000000C00000000001100000000001111
1100000000000000000000001100000000001111
1111111111111100111111111111111100001111
11111111111111001111X0000000001100001111
1111111111111100111100000000001111D11111
1111111111111100111100000000001111000001
111111111111110000000000C00000111d0000D1
1111111111111111100000000000001111000111
111111111111111111111111111D1110d0000101
100X0000000000000000000X00000X1011000101
100000000000000000000000000000101111D101
10000000000000X0X0X0X0X0X0X0X01011000101
1000000000000000000000000000001011111101
11111111111111111111111111111110000000C1
1111111111111111111111111111111111111111
