

								



NO 		 ./img/wall/North.xpm
SO                                                                          ./img/wall/South.xpm
WE																			./img/wall/West.xpm
EA	 	 	 	 ./img/wall/East.xpm


F 255 	, 	255 ,             125
C		 0	,	 100       ,								255

11111111111111111111111111111111111111111111111111111111111111111111111111111111111111111111111111111111111
10111111111111111111111111111111111111111111111111111111111111111111111111111111111111111111111111111111111
10100000000011111111111111111111111111111111111111111111111111111111111111111111111111111111111111111111111
10101111101000011111111111111111111111111111111111111111111111111111111111111111111111111111111111111111111
10101111101111011111111111111100000000001111111111111111111111111111111111111111111111111111111111111111111
100011111D1111011111111111111100000000001111111111111111111111111111111111111111111111111111111111111111111
11111111111110011110000000000d00000000001111111111111111111111111111111111111111111111111111111111111111111
11111111100000011110111111111100000000001111111111111111111111111111111111111111111111111111111111111111111
11111111101110011110111111111111111111111111111111111111111111111111111111111111111111111111111111111111111
11111111101110001100111111111111111111111111111111111111111111111111111111111111111111111111111111111111111
11111111101111000000111111111111111111111111111111111111111111111111111111111111111111111111111111111111111
11111111101111111110000111111111111111111111111111111111111111111111111111111111111111111111111111111111111
11111000d00000001110100100111111111111111111111111111111111111111111111111111111111111111111111111111111111
11110001111011111110100100111111111111111111111111111111111111111111111111111111111111111111111111111111111
11100001111011111110100100111111111111111111111111111111111111111111111111111111111111111111111111111111111
11100001111011111110100100111111111111111111111111111111111111111111111111111111111111111111111111111111111
11100001111011111110100100111111111111111111111111111111111111111111111111111111111111111111111111111111111
11111111111011111110100100000111111111111111111111111111111111111111111111111111111111111111111111111111111
11111111111011111110100100000111111111111111111111111111111111111111111111111111111111111111111111111111111
11111111111011111110100100000111111111111111111111111111111111111111111111111111111111111111111111111111111
111111111110111111100d0000000000000000001111111111111111111111111111111111111111111111111111111111111111111
11111111111011111110001111111100000000001111111111111111111111111111111111111111111111111111111111111111111
11111111111D111111100d0000C11100000000001111111111111111111111111111111111111111111111111111111111111111111
11111111111C111111111111X0011100000000001111111111111111111111111111111111111111111111111111111111111111111
11111111111111111111111111111111111111111111111111111111111111111111111111111111111111111111111111111111111