

								



NO 		 ./img/wall/North.xpm
SO                                                                          ./img/wall/South.xpm
WE																			./img/wall/West.xpm
EA	 	 	 	 ./img/wall/East.xpm


F 255 	, 	255 ,             125
C		 0	,	 100       ,								255


			 

			 


111 1111111111111111111111111111111111111111
1N1100000X00C11X0000000000X10000000000011111
10110110000011100000C000000d0000000000011111
1011CX10000000000000000000010000000000011111
1011111111D11111111111111111111D111111111111111111111111111111111111111111111
10111111110110000X111000000000000d0000000000C1111111000000000000C1111111111111
1000000000001100000d000000000000X0011111111111111111011111111111111
111101111111111111000000100011111111             111011
11110111111111X1110101001000111                  111011
1100000011010101110000001000111                  111011
1000000X0000000X1100D0001000111                  111011
1000000000X00000110101101000111                  111011
11CXCCC1110101011111X1C11111111                  111011
11110111 1110101 10111D10000111                  100D01
11110111 1110011 10000000000001                  100001
1C110111 1111011 10000000000001                  100001
10110111 10X1011 10000000C00001                  10X001
10000111 1011011110000000000001                  100001
11111111 10000000d000000000000111111111111111111110000111111111111111111111111111111111111111111111111111
1111111111101111110000000000000X0000000000011100000000000000000000000000000000000000001100000011000000101
1C00000000001111 10000000X00000110000000100000000000C000000000000000d00000000000000000d00000000dX0000dC11
10000000X1111111 1000000000000011000000111010000000000000000000000000000000000000000001100000011000000101
1111111111111111 1000000000000000000000000010000001000000111111111111111111111111111111100000011111111111
1111111111111111110000111000001111111111111111111111D1111111111111111111111111111111111111111111111111111
11000000000000000d00000C0000001000000000000000000000000X000000000000100000000000000000000X00000000X000001
1101111111111111110000000000001000000000000000000000000C0000000111111001110000000000000000000C00000000001
11011111 1111111 1000000000000100000X0000000000000000X0000000001000010C1000000000000000000000000000000001
11011111 1111111 1000000000000100000000000000000000000000X0001110000111100000000000000000X0000000000X0001
110XX0C1 1111111 1C000000000001C0000000000000000000000000000000000000000000000000000000000000000000000001
11111111 1111111 1111111111111111111111111111111111111111111111111111111111111111111111111111111111111111
				 
					  

                         
                       
                       





