

								



NO 		 ./img/wall/North.xpm
SO                                                                          ./img/wall/South.xpm
WE																			./img/wall/West.xpm
EA	 	 	 	 ./img/wall/East.xpm


F 255 	, 	255 ,             125
C		 0	,	 100       ,								255


			 

			 


       				       		    		1111111111111111111111111
       				       		    		1000000000110000000000001
       				       		    		1011000001110000000000001
       				       		    		1001000000000000000000001
11111111111111111111111111111111111111111111111111111111111111111111111111111
11111111101100000111000000000000111111111111111111111111111111111111111111111111111111111111111
10000000001100000d0000000000000001
1111011111111101110000001000111111
11110111111111011101010010001
11000000110101011100000010001
10000000000000001100100010001
10000000000000001101010010001
1100000111010101111101000000111                  111111
11110111 1110101 101DDD01000111                  100D01
11111111 1111111 10000000000001                  100001
11111111 1111111 10000000C00001                  100001
11111111 1111111 10000000C00001                  100001
11111111 1111111 10000000C00001                  100001
11111111 1111111 1000000000000111111111111111111110000111111111111111111111111111111111111111111
11111111 1111111 100000N000000000000000000011100000000000000000000000000000000000000001100000011
11111111 1111111 100000000000001100000001000000000000000000000000000000000000000000000d000000011
11111111 1111111 100000D000000011000000111010000000000000000000000000000000000000000001100000011
11111111 1111111 100001C100000000000000000010000001000000111111111111111111111111111111100000011
11111111 1111111 1000001000000111111111111111111111111111111111111111111111111111111111111111111
11111111 1111111 10000000000001
11111111 1111111 10000000000001
11111111 1111111 10000000000001
11111111 1111111 10000000000001
11111111 1111111 10000000000001
11111111 1111111 11111111111111
				 
					  

                         
                       
                       





