

								



NO 		 ./img/wall/North.xpm
SO                                                                          ./img/wall/South.xpm
NO 		 ./img/wall/North.xpm
WE																			./img/wall/West.xpm
EA	 	 	 	 ./img/wall/East.xpm
NO 		 ./img/wall/North.xpm
EA	 	 	 	 ./img/wall/East.xpm


F 255 	, 	255 ,             125
F 255 	, 	255 ,             125
C		 0	,	 100       ,								255


			 

			 


       				       		    		1111111111111111111111111
       				       		    		1000000000110000000000001
       				       		    		1011000001110000000000001
       				       		    		1001000000000000000000001
11111111111111111111111111111111111111111111111111111111111111111111111111111
1111111110110000X111000000000000111111111111111111111111111111111111111111111111111111111111111
10000000001100000d000000000000X001
1111011111111101110000001000111111
11110111111111011101010010001
11000000110101011100000010001
1000000X0000000X1100100010001
1000000000X000001101011010001
11CXCCC1110101011111X1C10000111                  111111
11110111 1110101 101D1D1D000111                  100D01
11111111 1110011 10000000000001                  100001
11111111 1111011 1000S000000001                  100001
11111111 10X1011 10000000C00001                  10X001
11111111 1011011110000000000001                  100001
11111111 10000000d000000000000111111111111111111110000111111111111111111111111111111111111111111111111111
1111111111101111110000000000000X0000000000011100000000000000000000000000000000000000001100000011000000101
1C00000000001111 10000000X00000110000000100000000000C000000000000000d00000000000000000d00000000dX0000dC11
10000000X1111111 1000000000000011000000111010000000000000000000000000000000000000000001100000011000000101
1111111111111111 100000D000000000000000000010000001000000111111111111111111111111111111100000011111111111
11111111111111111100001C100000111111111111111111111111111111111111111111111111111111111111111111111111111
11000000000000000d00000D000000d000000000000000000000000X000000000000100000000000000000000X00000000X000001
1101111111111111110000000000001000000000000000000000000C0000000111111001110000000000000000000C00000000001
11011111 1111111 1000000000000100000X0000000000000000X000000000100001001000000000000000000000000000000001
11011111 1111111 1000000000000100000000000000000000000000X0001110000111100000000000000000X0000000000X0001
110XX0C1 1111111 1C000000000001C0000000000000000000000000000000000000000000000000000000000000000000000001
11111111 1111111 1111111111111111111111111111111111111111111111111111111111111111111111111111111111111111
				 
					  

                         
                       
                       





